rein: bagdor, generally oldest person in the family used to have reins for the family.
Relinquish: abandoned, छोड़ना / त्यागना  : You should relinquish a bad habit.
RELINQUISHMENT= संन्यास
CONFIDE= गुप्त बात बताना
SHROUD= कफ़न  ..  She didnt have money to buy a shroud for her husband.
SHROUD= छिपाना ...... Baahubali 2 trailer is released but why Kattappa killed Baahubali still remains shrouded in mystery.
VESTIGE= पगडण्डी
RITE= धार्मिक संस्कार
MARTYRED= यातनाग्रस् त 
DECREE= आदेश          The decree was issued by a ruler.
DEFY= सामना करना, निपटना     The politician defied public opinion
SUE= किसी पर मुकदमा कायम करना............... Shes suing for a divorce.
CREMATE= शव जलाना
Delusion: dhokha, bhram
Fugitive: pharar, bhagaura
STRINGENT= सख्त 
CONVICTION= दृढ़ विश्वास 
CONVICTION= दोषी ठहराया जानाआ       the conviction came as no surprise
CONFISCATION= ज़ब्ती           The land near our school is under the confiscation of government.
DEFAULTER= बाकीदार      The defaulter could not pay back the loan in due time.
FUME= क्रोध करना      He fumed at his servants for irregular work.
OFFENDER= CULPRIT, अपराधी  The offender was seriously punished.
ACCORD= सहमति    we are in accord with your proposal
TO LESSEN: kam karna, reduce
LIAISON= सम्पर्क           he provided a liaison with the guerrillas
PARADOX= विरोधोक्ति
PRUDENT= वुद्धीमान 
RAZED= torn down and broken up
FOIST= बेवकूफ बनाना
INCARNATION= अवतार 
DOOM= बरबाद होना
SPOOKY= डरावना 
ORCHESTRATE= योजना बनाना
TEASER= उत्सुकता जगाने वाला विज्ञापन
MONOLITHIC= विशालकाय
NEOPHYTE= नौसिखिया, नवशिष्य
Glitch= defect
forego = tyagna
JEOPARDIZE= जोखिम मेँ डालना
inkling= abhaas